..........
..........
..........
..........
.....XX...
....XX....
....X.X...
..........
..........
..........
