..XX...X.X
.XXX......
....XX...X
.X..XX..XX
.......X..
..XXX.X...
..X.X....X
..X.X..XX.
......XX.X
......X..X
