.X..XX....
..X.X....X
.XXX..X...
X....XX..X
....XX....
.XX.XXX..X
.....XX.X.
.X.XXX..XX
.......X..
..X..X.XX.
