......XXXX
X..XX..XX.
..XXX...XX
.X..X.X...
.X.X......
.X......X.
.X.....X..
...X....X.
XX..XX....
.X.....X..
